NO ./worlds/so_long/textures/play.xpm
SO  ./worlds/so_long/textures/exit.xpm
WE ./worlds/so_long/textures/fire.xpm
EA ./worlds/so_long/textures/collect.xpm

F 55,55,     55
C         100, 100         ,        100

                   1111111111111111111111111111111111111111111111111
                  1                                                 1
                  1                                                 1
                  1  111111 111111  11     111111 11  11 111111     1
                  1  111111 111111  11     111111 11  11 111111     1
                  1  11     11  11  11     11  11 11  11 11         1
                  1  11     11  11  11     11  11 111 11 11         1
                  1  111111 11  11  11     11  11 111111 11      W  1
                  1                                                 1
                  1      11 11  11  11     11  11 11 111 11  11     1
                  1      11 11  11  11     11  11 11  11 11  11     1
                  1  111111 111111  111111 111111 11  11 111111     1
                  1  111111 111111  111111 111111 11  11 111111     1
                  1                                                 1
                  1                                                 1
                   1111111111111111111111111111111111111111111111111
