NO ./worlds/so_long/textures/play.xpm
SO  ./worlds/so_long/textures/exit.xpm
WE ./worlds/so_long/textures/fire.xpm
EA ./worlds/so_long/textures/collect.xpm

F 55,55,     55
C         100, 100         ,        100

1111111111111111111111111111111111111
1000000000000000000000000000000000001
10S0000000000000000000000000000000001
1000000000000000000000000000000000001
1000000000000000000000000000000000001
1000000000000000000000000000000000001
1000000000000000000000000000000000001
1000000000000000000000000000000000001
1000000000000000000000000000000000001
1000000000000000000000000000000000001
1000000000000000000000000000000000001
1000000000000000000000000000000000001
1000000000000000000000000000000000001
1111111111111111111111111111111111111
