NO ./worlds/david/textures/me.xpm
SO  ./worlds/david/textures/me.xpm
WE ./worlds/david/textures/me.xpm
EA ./worlds/david/textures/me.xpm

F 0,100,     0
C         0, 0         ,        70

1111111111111111111111111111111111111
1S00000000000000000000000000000000001
1000000000000000000000000000000000001
1001111000111111001100110110111100001
1001111000111111001100110110111100001
1001100110110011001100110110110011001
1001100110110011001100110110110011001
1001100110111111001100110110110011001
1001100000000000000000000000000011001
1001100110110011001100110110110011001
1001100110110011001100110110110011001
1001111000110011000011000110111100001
1001111000110011000011000110111100001
1000000000000000000000000000000000001
1000000000000000000000000000000000001
1111111111111111111111111111111111111
