NO textures/wolfenstein/grey_stone.xpm
SO textures/wolfenstein/purple_stone.xpm
WE textures/wolfenstein/red_brick.xpm
EA textures/wolfenstein/wood.xpm

F 220,100,0
C 225,30,0

        11111111          1111111
        1  1000011  11 111 01
          10000001    10000001111
           1000001  1110000000001
111 11111111000001    10000000001
101 1 1 1011000001111111111 01111
111     111111011100000010001
11111 11111111011101010010001
11001         111100000010001
100011111111110001100000010001
10000    000000110101001000 11111111111
11000001110101011 11011110N0100000000001
11110111 1110101  0111101001 11111111111
    1111111 1111111 11111111
