NO textures/wolfenstein/grey_stone.xpm
SO textures/wolfenstein/purple_stone.xpm
WE textures/wolfenstein/red_brick.xpm
EA textures/wolfenstein/wood.xpm

F 220,100,0
C 225,30,0

 1          1111          11       1
1S1        1 0001      111 01 1111101
1 1       10000001    100000010000001
1 1        1000001   1 0000000011111
101      11 000001    10000000001
101     1   10000 1111      0111
1 1      1 1 10   000000 0001
1  1      1  10    0 0 00 0001
1 001         1   000000 0001
1000 111111111000  000000 0001
10000    000000  0 0 00 000   111111
1 00000   0 0 0     0       0000000 1
 1110      1   1   1        11111111
    1111111 111 111 11111111
