NO ./worlds/verify/textures/north.xpm
SO ./worlds/verify/textures/south.xpm
WE ./worlds/verify/textures/west.xpm
EA ./worlds/verify/textures/east.xpm

F  164, 169,205               
C 153 ,204,  255

111111111111111
1000000000001111111111
10000E0000001       101
1000000000001111111111
1000000000000000000001
1111111111111111111111
