1111111111111111
1111111111111001
111111111111P0001
1111111111E00C11
1111111111111111
